1 0 0 0 0 1 0 3 4 5 1 2 3
1 0 0 0 0 3 0 4 0 0 0 0 5
1 0 0 0 0 5 0 5 0 0 0 0 3
5 0 0 0 0 3 0 2 0 0 0 0 4
3 0 0 0 0 4 0 1 0 0 0 0 1
1 4 3 5 2 1 0 2 0 0 0 0 2
